###############
# #   # #     #
#   # # ### # #
##### # # # # #
#     #   # # #
# ### # # ### #
# #     #     #
######### #####
#             #
# # ######### #
# #         # #
# ########  # #
# ######## ## #
#   #      @ e#
###############