###############
#@#   #       #
# #e# # ##### #
# ### # # # # #
# #   #   #   #
# ### # ### ###
# #     #     #
# ####### #####
# #     #     #
# # ####### ###
# # ### ### # #
#   #         #
# ########### #
#             #
###############