###############
# #   #       #
#@#e# ### ### #
# ### # # # # #
# #       #   #
# ######### ###
#       #     #
# ### ####### #
# #     #   # #
# # ####### # #
# # ### ### # #
# #         # #
# ########### #
#             #
###############