###############
#@# #   #     #
#   # # # # # #
# ### # # # # #
#     #   # # #
# ##### ##### #
#  #    #     #
########### ###
#         # # #
# ######### # #
# #           #
# ######### # #
# ######### # #
#           #e#
###############