###############
# #           #
#@#e# ####### #
# ### # # # # #
# #   #   #   #
# ##### ### ###
# #     #     #
# ### ####### #
# #     #     #
# # ####### # #
# # ### ### # #
# #         # #
# ########### #
#             #
###############