###############
#@#   # #     #
#   # # ### # #
##### # # # # #
#     #   # # #
# ### # # ### #
# #     #     #
######### #####
#             #
# # ####### # #
# #e#       # #
# ########  # #
# ########  # #
#        #  # #
###############