###############
#@            #
# ##### ##### #
#             #
# ##### ##### #
#             #
# ##### ##### #
#             #
# ##### ##### #
#             #
# ##### ##### #
#           # #
# #############
#       e     #
###############