###############
# # #   #     #
#   # # # # # #
# ### # # # # #
#     #   # # #
# ##### #######
#  e#        @#
########### ###
#           # #
# ########### #
# #           #
# ######### # #
# ######### # #
#           # #
###############